101,102,0,0,103,0,107,102,108,0
100,102,104,0,0,0,0,0,0,0
0,1,0,2,0,0,0,0,0,0
0,4,0,0,0,0,0,0,0,0
3,3,3,3,3,0,0,0,0,0
0,0,0,0,0,0,0,0,0,0
0,0,0,0,0,0,0,0,0,0
0,0,0,0,0,0,0,0,0,0
0,0,0,0,0,0,0,0,0,0
111,102,109,0,0,0,0,0,0,0
